11111111111111111111111111111111
10000000000000000000000000000011
10000000000000000000000000000011
10000000000000000000000000000011
10000000001111100100000000000011
10000000001000010100000000000011
10000000001000010100001000000011
10000000001000010100000000000011
10000000001000010100000000000011
10000000001000010100000000000011
10000000000000000000000000000011
11111111111111111111111111111111