NO Assets/mc1.xpm
SO Assets/mc2.xpm
WE Assets/mc3.xpm
EA Assets/mc4.xpm

F 0, 80, 0
C 153,204,255


111111111111111
1N0000000000001
111111111111111