 11111   1111111
10000011111
1000N1111101
111111111111
