111111111111111111111111111111111111111111111111111111111
100000000000000000000000000000000000000000000000000000001
100000000000000000000000000000000000000000000000000000001
100000000000000000001111111111111111111100000000000000001
100000001000000000000000000000000000000000000000000000001
100000100100000000001111111111111111111100000000000000001
100000010000000000000000000000000000000000000000000000001
100000000000000000000000000000000000000000000000000000001
100000000000000000001111111111111111111100000000000000001
100000000000N00000000000000000000000000000000000000000001
100000000000000000000000000000000000000000000000000000001
100000000000000000001111111111111111111100000000000000001
100000000000000000000000000000000000000000000000000000001
100000000000000000001111111111111111111100000000000000001
100000000000000000000000000000000000000000000000000000001
100000000000000000000000000000000000000000000000000000001
100000000000000000001111111111111111111100000000000000001
100000000000000000000000000000000000000000000000000000001
111111111111111111111111111111111111111111111111111111111