NO Assets/1.xpm
SO Assets/2.xpm
WE Assets/3.xpm
EA Assets/4.xpm

F 0, 80, 0
C 153,204,255


11111111111111111
1N000000000000001
11111111111111111